#################.############################
#o.......................@....#.............o#
#.###.######.######.###.#.######.###.######.##
#.###...............###.#..........#.....o#..#
#.###.#.#.#####.#.#.###.#.########.#.######.##
#.....#.#...b...#.#.....#..........#....#....#
#.#####.#.##.##.#.#.###.#.##########..###..#.#
........#.#icp#.#.#.#o........................
#################.############################