############.############
#o......................#
#.###.######@######.###.#
#.#...................#.#
#.###.#.#.#####.#.#.###.#
#.....#.#...b...#.#.....#
#.#####.#.##.##.#.#.###.#
........#o#icp#o#.#.#o...
############.############