############.############
#o......................#
#.###.######@######.###.#
#.###...............###.#
#.###.#.#.#####.#.#.###.#
#.....#.#...b...#.#.....#
#.#####.#.##.##.#.#.###.#
........#.#icp#.#.#.#o...
############.############