############.############
#o......................#
#.###.######@######.###.#
#.###...............###.#
#.###.#.#.#####.#.#.###.#
#.....#.#...b...#.#.....#
#.#####.#.##.##.#.#.###.#
........#.#icp#.#.#.#o...
#.#.###.#.#####.#.#.###.#
#.#o..............#.....#
#.#####.#.####.#.##.#####
#.......#......#........#
#.##########.##########.#
#......................o#
############.############