############.############
#o.....................o#
#.###.######@######.###.#
#.###...............###.#
#.###.#.#.#####.#.#.###.#
#.....#.#...b.....#.....#
#.#####.#.##.##.#.#.###.#
........#.#icp#...#o#o...
#########################